000000000000000000000000000000000000000000000000000000000000
000000000000000000000000000000000000000000000000000000000000
000000000000000000000000000000000000000000000000000000000000
000000000000000000000000000000000000000000000000000000000000
000000000000000000000000000000000000000000000000000000000000
000000000000000000000000000000000000000000000000000000000000
000000000000000000000000000000000000000000000000000000000000
000000000000000000000000000000000000000000000000000000000000
000000000000000000000000000000000000000000000000000011114444
333333333330000000000000000000000000000000000000000011111111
333333333330000000000000000000000000000000000000000011111111
111111111110000000000000000000011111111111111111111111111111
111111111110000000000000000000011111111111111111111111111111
111111111110000000000000000000011111111111111111111111111111
111111111110000000000000000000011111111111111111111111111111
111111111110000000111111111111111111111111111111111111111111
111111111110000000111111111111111111111111111111111111111111
111111111110000000111111111111111111111111111111111111111111
111111111110000000111111111111111111111111111111111111111111
111111111111111111111111111111111111111111111111111111111111
111111111111111111111111111111111111111111111111111111111111
111111111111111111111111111111111111111111111111111111111111
111111111111111111111111111111111111111111111111111111111111
111111111111111111111111111111111111111111111111111111111111
111111111111111111111111111111111111111111111111111111111111
111111111111111111111111111111111111111111111111111111111111
111111111111111111111111111111111111111111111111111111111111
111111111111111111111111111111111111111111111111111111111111
111111111111111111111111111111111111111111111111111111111111
111111111111111111111111111111111111111111111111111111111111
50 100