000000000000000000000000000000000000000000000000000000000000
000000000000000000000000000000000000000000000000000000000000
000000000000000000000000000000000000000000000000000000000000
000000000000000000000000000000000000000000000000000000000000
000000000000000000000000000000000000000000000000000000000000
000000000000000000000000000000000000000000000000000000000000
000000000000000000000000000000000000000000000000000000000000
000000000000000000000000000000000000000000000000000000000000
000000000000000000000000000000000000000000000000000011116444
333333333330000000000000000000000000000000000000000011111111
333333333330000000000000000000000000000000000000000011111111
111111111110000000000000000000011111111111111111111111111111
111111111110000000000000000000011111111111111111111111111111
111111111110000000000000000000011111111111111111111111111111
111111111110000000000000000000011111111111111111111111111111
111111111110000000111111111111111111111111111111111111111111
111111111110000000111111111111111111111111111111111111000000
111111111111000000111111111111111111111111111111111000000000
111111111111110000111111111111111111111111111111000000000000
111111111111111111111111111111111111111111111111000000000000
111111111111111111111111111111111111111111111111111110000000
111111111111111111111111111111111111111111111111111111111100
111111111111111111111111111111111111111111111111111111111111
111111111111111111111111111111111111111111111111111111111111
111111111111111111111111111111111111111111111111111111111111
111111111111111111111111111111111111111111111111111111111111
111111111111111111111111111111111111111111111111111111111111
111111111111111111111110000001111111111111111111111111111111
111111111111111100000000000000000000001111111111111111111111
111111111100000000000000000000000000000000001111111111111111
50 100