000000000000000000000000000000000000000000000000000000000000
000000000000000000000000000000000000000000000000000000000000
000000000000000000000000000000000000000000000000000000000000
000000000000000000000000000000000000000000000000000000000000
000000000000000000000000000000000000000000000000000000000000
000000000000000000000000000000000000000000000000000000000000
000000000000000000000000000000000000000000000000000000000000
000000000000000000000000000000000000000000000000000000000000
000000000000000000000000000000000000000000000000000000000000
333333330000000000000000000000000000000000000000000000000000
333333330000000000000000000000000000000000000000000000000000
111111110000011111111111110000000000000000000000000000000000
111111110000011111111111110000000000000000000000000000000000
111111110000011111111111110000011111111100000000000000000000
111111110000011111111111110000011111111100000000000000000000
111111110000011111111111110000011111111100000000000000000000
111111110000011111111111110000011111111100000000000000000000
111111110000011111111111110000011111111100000000000000000000
111111110000011111111111110000011111111100000000000000000000
111111110000011111111111110000011111111100000000000000000000
111111110000011111111111110000011111111100000000000011116444
111111110000011111111111110000011111111100000000000011111111
111111110000011111111111110000011111111100000000000011111111
111111110000011111111111110000011111111100000000000011111111
111111110000011111111111110000011111111100000000000011111111
111111110000011111111111110000011111111100000000000011111111
111111110000011111111111110000011111111100000000000011111111
111111110000011111111111110000011111111100000000000011111111
111111110000011111111111110000011111111100000000000011111111
111111110000011111111111110000011111111100000000000011111111
50 100