000000000000000000000000000000000000000000000000000000000000
000000000000000000000000000000000000000000000000000000000000
000000000000000000000000000000000000000000000000000000000000
000000000000000000000000000000000000000000000000000000000000
000000000000000000000000000000000000000000000000000000000000
000000000000000000000000111111111111110000000000000000000000
111111110000000000000000111111111111111111000000000000000000
111111111111100000000000111111111111111111111000000000000000
111111111111100000000000111111111111111111111000000000000000
111111111111100000000000555000000000000000000000000000000000
000000000000000000000000555000000000000000000000000000000000
000000000000000000000111555000000000000000000000000000000000
000000000000000000111111555000000000000000000000000000000111
000000000000000001111111555000000000000000000000000011111111
000000000000000111111111555000000000000000000111111111111111
000000000000000000000000555000000000000000000111111111111111
000000000000000000000000555000000000000000000000011111111111
111110000000000000000000555000000000000000000000000011111111
111111111100000000000000555000000000000000000000000000001111
111111111100000000000000555000000000000000000000000000000000
111111111100000000000000555111111111100000000000000000000000
000000000000000000000000555111111111100000000000000000000000
000000000000000111111111555111111111100000000000000000000000
000000000000000111111111555111111111100000000000000000000000
000000000000000111111111550000000000000000000000000000000000
333333333300000000011111550000000000000000000000000000004444
333333333300000000000011550000000000000000000000001111111111
111111000000000000000011550000000000000011111111111111111111
111100000000000000000011550000000000001111111111111111111111
110000000000000000000011550000000001111111111111111111111111
50 450
