000000000000000000001111111111100000000000000000000000000000
000000000000000000000111111111100000000000000000000000000000
000000000000000000000001111111100000000000000000111100000000
000000000000000000000000111111100000000000000001111110000000
000000000000000000000000011111100000000000000000011100000000
333333333000000000000000011111100000000000000000000000000000
333333333000000000000000011111100000000000000000000000000000
111111000000000000000001111111111110000000000000000000000000
111000000000000000000111111111111111110000000000000000000000
000000000000000000001111111111111111111101111100000000000000
000000000000000000001111111111111111111100111000000000000000
000000555555555555551111111110000000111100000000000000000000
000000111111111111111111100000000000001100000000000000000000
000000000000000000000000000000000000000000000000000000000000
000000000000000000000000000000000000000000000000000000000000
000000000000000000000000000000000000000000000000000001111100
000000000000000000000000000000000000000000000000000000011000
000000000000000000000000000000000000000000000000000000000000
000000000000000000000000000000000000000000000000000000000000
111111222221111111222221111111100022200011111111000000000000
111111111111111111111111111111100011100011111110000000000000
111111111111111111111111111111100011100011111110000000000000
111111111111111111111111111111100011100011111110000000000000
111111111111111111111111111111100011100011111100000000000000
111111111111111111111110000000000011100000111100000000000000
111111111110000000000000000000000011100000111100000000006444
111000000000000000000000000000000011100001111100000000001111
111000000000000000000000000000000111100001111100000000001111
111100000000000000000000000000001111110000111100000000001111
111111000000000000000000000000001111111000011000000000001111
50 60
